5 5 3 1 3
0 0 0 0 0
0 0 3 0 0
0 1 3 3 0
0 0 0 2 2
0 0 0 0 0
0 0 0 0 0
0 0 0 0 0
0 0 0 0 0
0 0 0 0 0
0 0 4 4 4