4 6 2 5 3
0 0 0 2 2 2
0 0 3 0 0 0
3 0 0 2 3 1
0 0 2 2 0 0
4 4 4 0 0 0
0 0 0 0 0 0
0 0 0 0 0 0
0 0 0 0 0 0