5 5 3 0 3
2 0 0 0 0
2 0 0 3 0
2 2 3 0 0
1 3 0 0 0
0 0 2 0 0
0 0 0 0 4
0 0 0 0 4
0 0 0 0 4
0 0 0 0 0
0 0 0 0 0